*************************************************************************
*...*...............*...............*...........*...................*...*
*...*...*********...*...*****...*********...*****...*****...*****...*...*
*...............*.......*...*...........*...........*...*...*.......*...*
*********...*...*********...*********...*****...*...*...*...*********...*
*.......*...*...............*...........*...*...*...*...*...........*...*
*...*...*************...*...*...*********...*****...*...*********...*...*
*...*...............*...*...*.......*...........*...........*.......*...*
*...*************...*****...*****...*...*****...*********...*...*****...*
*...........*.......*...*.......*...*.......*...........*...*...........*
*...*****...*****...*...*****...*...*********...*...*...*...*************
*.......*.......*...*...*.......*.......*.......*...*...*.......*.......*
*************...*...*...*...*********...*...*****...*...*****...*****...*
*...........*...*...........*.......*...*.......*...*.......*...........*
*...*****...*...*********...*****...*...*****...*****...*************...*
*...*.......*...........*...........*.......*...*...*...............*...*
*...*...*********...*...*****...*********...*...*...*************...*...*
*...*...........*...*...*...*...*...........*...............*...*.......*
*...*********...*...*...*...*****...*********...*********...*...*********
*...*.......*...*...*...........*...........*...*.......*...............*
*...*...*****...*****...*****...*********...*****...*...*********...*...*
*...*...................*...........*...............*...............*...*
*************************************************************************