****************************************************************
*........*........*............................................*
*..****..*..*******..****************************..**********..*
*.....*.....*........*.....*....................*.....*........*
****..*..****..*******..*..*..*.....**********..****..*..*******
*.....*..*.....*........*.....*.................*.....*........*
*..****..*..****..*********.*********..*******..**********..****
*..*.....*..*.....*....................*.....*.................*
*..*******..****..*..**********........*..*..****..*..*******..*
*........*..*.....*.....*.....*...........*.....*..*...........*
*..****..........*****..****..*..*************..*..*************
*..*.....*..*........*........*..............*.................*
*..*..****..*************..*..*************..*..****..****..****
*..*..*....................*..............*..*.....*..*..*.....*
*..*..*..**********************..*******..**.****..*..*..****..*
*..*........*.....*....................*..*.....*..............*
*..*******..*..*..*..****..*******..*******..*..*..****..*..****
*..*........*..*..*.....*...........*........*..*.....*..*.....*
*..*..*******..*..****..*..**********..**********..*..*..****..*
*..*..*........*........*.....*.....*...........*..*........*..*
*..*..*..*************..****..*..*************..*..**********..*
*..*.......................*..*.................*...........*..*
*..*..****************************..*******..**********..****..*
*..*........*.....*..*................**..............*..*.....*
*..*******..*..*..*..*........****....**..****..*******..*..****
*...........*..*..*..*................**..*.....*.....*..*.....*
*..****..****..*..*..*..****************..*..****..*..*..*******
*...........*..*..*..*.................*..*..*.....*...........*
**********..****..*..********.*******..*..*..********.****.**..*
*.................*.......................*..............*.....*
****************************************************************