****************
*....*.........*
*..****..*..****
*............***
**********....**
*..............*
*..*..****..*..*
*.*....*....*..*
*..**********..*
*.*.........*..*
*..*..****..*..*
*....*....*.*..*
*..****..****..*
*......,....*..*
****************