*************************************
*.*****.*...*.***.*.................*
*.........*.......***.*******.*.*.*.*
*.*.*.***********.....*****.*******.*
*.***.........***.*******.......***.*
*.***.*.***.*.*.*.*****...***.*****.*
***********.*.....***...*********.*.*
*...*********.*.***.*.*******.*...*.*
*.*...*********.....*.***.....*.***.*
***.*.......*...***...*****.*.*.*.*.*
*...*****.*...***...***.....*.......*
*************************************